111111
1C1101
111101
1P00E1
111111
