111111
10C111
1P0E1
10C01
100001
111111
