111111111111111
1000000001C00C1
10C011100101111
1000110001C00C1
111110CC0111101
111110CC0000001
1P00000000000E1
111111111111111
